Name,Volume,Ask Size,Ask Price,Bid Size,Bid Price,Last Price,Shares Matched,Shares Routed
MSTU,9642064,400,7.78,1200,7.77,7.79,9559414,82650
TSLZ,5568240,6700,3.49,6805,3.48,3.49,5485069,83171
MSTZ,2819037,600,10.52,600,10.49,10.49,2716048,102989
ETHU,1516433,40190,2.38,40000,2.36,2.37,1516433,0
NVDQ,1325283,7880,3.10,8356,3.09,3.10,1325283,0
TSLT,961785,800,16.11,931,16.08,16.10,947902,13883
INDA,870837,6,52.10,8,52.09,52.09,823481,47356
NVDX,838495,1204,9.66,1401,9.64,9.66,838123,372
BITX,775034,1400,40.93,1400,40.83,40.93,773437,1597
UVXY,772221,300,19.48,122,19.40,19.48,748783,23438
IGV,684432,180,96.80,1,96.47,96.48,682194,2238
USHY,681554,27,37.25,50,37.05,37.05,681311,243
VXX,651092,200,45.31,2,45.30,45.27,643633,7459
IEFA,567202,1,78.23,100,77.92,77.97,532526,34676
GOVT,434479,1238,22.86,20,22.81,22.84,434117,362
ITB,384302,100,100.00,100,93.75,97.12,383392,910
USMV,328638,17,100.00,10,92.30,92.85,317118,11520
SVIX,326132,2,23.18,703,23.03,23.06,306116,20016
ARKG,313908,1,23.84,22,23.33,23.48,311389,2519
UVIX,303884,190,29.74,10,29.10,29.28,300662,3222
IYZ,263345,1,29.16,0,0.00,27.68,263300,45
MAGS,257606,100,49.65,5,49.15,49.57,251422,6184
CALF,214171,10,39.00,5,36.38,38.75,214020,151
MTUM,201307,5,215.00,10,194.00,210.61,200977,330
FBTC,193300,3000,76.57,2700,76.40,76.26,189546,3754
CBOE,191998,20,230.01,1,180.00,214.22,191545,453
NOBL,178418,730,102.00,105,100.00,100.99,176290,2128
IAGG,170291,0,0.00,0,0.00,49.83,170040,251
ROBN,168200,717,16.95,600,16.87,16.97,167069,1131
SPYI,166267,10,49.95,93,49.67,49.95,165854,413
EFV,157712,384,60.35,54,54.00,60.32,157659,53
COWZ,155157,251,55.80,1,54.00,55.38,154604,553
EZU,144410,25,55.44,100,54.00,55.11,144409,1
BBJP,143541,7,61.00,0,0.00,58.66,143539,2
MOAT,133214,1,91.45,10,89.80,90.00,132221,993
AAAU,125332,10100,29.94,10100,29.81,29.84,124622,710
ITA,112346,7,159.50,32,158.00,159.50,112346,0
QUAL,105727,0,0.00,0,0.00,174.84,103119,2608
SVXY,101066,100,48.99,100,48.79,48.80,97989,3077
PAVE,99817,5,47.00,1,38.00,39.34,96040,3777
VLUE,97474,0,0.00,0,0.00,108.42,97474,0
JBBB,96966,90,48.88,0,0.00,48.69,96965,1
IDV,96184,0,0.00,5,31.27,31.38,96184,0
EUAD,95974,4,35.00,6,34.43,34.72,95973,1
VIXY,90178,100,44.49,200,44.21,44.26,89749,429
REM,89069,0,0.00,1,21.00,22.76,89060,9
VNM,81300,2118,12.69,213,12.50,12.69,78565,2735
ARKB,77028,2600,87.48,2100,87.30,87.74,76884,144
EFAV,71273,0,0.00,0,0.00,78.16,68838,2435
IYT,69346,2,65.92,1,65.44,65.65,68894,452
SDVD,69225,0,0.00,0,0.00,20.47,67132,2093
LVHI,64456,0,0.00,153,32.60,32.85,62254,2202
FLOT,62670,200,51.05,200,51.00,51.02,62670,0
HEFA,60373,0,0.00,1,32.60,37.35,60373,0
BOXX,58686,226,111.39,4294,111.38,111.39,58176,510
FETH,55180,10000,20.67,10000,20.55,20.70,55178,2
PBUS,53776,0,0.00,0,0.00,57.79,29078,24698
JCPB,53631,35,46.90,0,0.00,46.83,40031,13600
BTCZ,53420,800,5.89,10,5.85,5.90,53420,0
ITM,51896,0,0.00,0,0.00,45.61,46174,5722
ICSH,49726,2447,50.62,3000,50.61,50.62,49726,0
RDVI,49362,500,24.39,0,0.00,24.25,49362,0
FOCT,48446,0,0.00,0,0.00,42.35,48446,0
BTCI,47515,0,0.00,1,54.08,54.47,47515,0
HYD,43844,100,52.90,50,51.40,51.54,39801,4043
EFG,42381,0,0.00,0,0.00,103.64,42381,0
BUFR,41786,0,0.00,0,0.00,30.29,41786,0
FSEP,41651,0,0.00,0,0.00,45.46,41651,0
FBCG,39816,0,0.00,0,0.00,43.02,39291,525
TLTW,39521,4,23.86,4,23.83,23.84,39326,195
IWMI,37586,0,0.00,5,43.03,46.50,37586,0
GOVZ,36114,0,0.00,1,10.05,10.07,36114,0
HODL,35234,8000,24.90,8000,24.75,24.99,34432,802
VUSB,35159,397,49.83,3,49.64,49.80,35059,100
OVL,30520,0,0.00,0,0.00,45.59,30520,0
BBEU,29332,0,0.00,0,0.00,63.41,29332,0
QDTE,28918,1000,36.93,1000,36.84,36.91,28917,1
MLN,27950,0,0.00,0,0.00,17.40,27950,0
KNG,26364,0,0.00,2,49.13,50.23,26265,99
JMST,26358,0,0.00,0,0.00,50.90,26258,100
DFIC,25208,0,0.00,0,0.00,28.52,23708,1500
BBCA,24955,0,0.00,0,0.00,73.16,24955,0
EEMV,24352,7,58.96,0,0.00,58.96,23135,1217
BBAX,23724,0,0.00,0,0.00,49.32,23724,0
CNYA,22879,0,0.00,1,26.55,28.33,22879,0
PICK,22331,0,0.00,0,0.00,38.07,20831,1500
BUYW,20789,0,0.00,2,13.89,13.91,20789,0
ICF,20742,0,0.00,0,0.00,60.65,20585,157
GSEW,20229,0,0.00,2,74.08,77.67,20094,135
GCOW,20038,0,0.00,0,0.00,37.29,20038,0
ECH,19992,1,31.12,0,0.00,30.76,19764,228
MAGX,19697,100,36.82,5,36.60,36.70,19697,0
SMIN,19660,0,0.00,5,45.00,69.08,18747,913
ACWV,19580,0,0.00,0,0.00,115.48,16702,2878
XVV,19499,0,0.00,0,0.00,44.20,19399,100
NUSC,18856,0,0.00,100,36.20,39.80,18856,0
IBHF,18602,150,24.19,0,0.00,23.24,18602,0
ICVT,18497,0,0.00,0,0.00,86.00,17497,1000
CEMB,17466,0,0.00,0,0.00,45.20,17466,0
SLVP,16670,0,0.00,3,14.94,15.04,16660,10
IFRA,16416,0,0.00,0,0.00,45.79,14491,1925
ESGV,15987,9,104.95,10,101.00,101.50,15487,500
IBHI,15721,0,0.00,0,0.00,23.46,15721,0
YBTC,15511,40,42.59,15,42.15,42.58,15511,0
UDEC,15404,0,0.00,0,0.00,34.82,13404,2000
NEAR,15067,100,51.04,5,50.09,50.74,15067,0
DFIS,14637,0,0.00,0,0.00,26.65,14637,0
BUFD,14589,0,0.00,0,0.00,25.35,13889,700
JMUB,14386,0,0.00,0,0.00,50.02,14386,0
GMAR,13569,0,0.00,0,0.00,37.69,13569,0
YETH,13471,5,44.44,100,30.60,30.90,13471,0
BALT,13316,0,0.00,0,0.00,31.39,12516,800
VIXM,13296,1,17.60,3,14.70,14.84,13196,100
PTLC,12815,0,0.00,0,0.00,52.11,12815,0
FJAN,12770,0,0.00,0,0.00,45.24,12770,0
VTEC,12733,0,0.00,50,98.50,98.65,12733,0
AAPX,12303,40,24.80,1300,24.71,24.67,12303,0
XSHD,12253,1980,14.40,9,13.75,13.99,12133,120
IYJ,12142,0,0.00,0,0.00,133.08,12142,0
XDTE,11966,1000,47.08,1,46.95,47.01,11966,0
DIVB,11891,0,0.00,215,47.05,48.57,11891,0
BBIN,11885,0,0.00,0,0.00,63.24,11604,281
XAPR,11301,0,0.00,0,0.00,32.86,11301,0
ICOW,10797,0,0.00,0,0.00,32.35,10797,0
USMF,10660,0,0.00,0,0.00,50.27,10660,0
ETHV,10644,3500,30.22,7000,30.17,30.40,10644,0
SYLD,10618,0,0.00,0,0.00,65.02,10618,0
QMAR,10288,0,0.00,0,0.00,29.09,10288,0
HYDB,10163,0,0.00,1,45.00,47.42,9963,200
FLQM,10102,0,0.00,0,0.00,53.33,10102,0
HIMU,9879,0,0.00,0,0.00,49.63,8769,1110
ESML,9772,0,0.00,0,0.00,39.89,9772,0
BTCW,9592,2500,93.18,2400,92.27,93.36,9592,0
HYBL,9500,3,30.00,20,27.86,28.25,9500,0
REGL,9495,0,0.00,0,0.00,80.93,9495,0
BUFQ,9190,0,0.00,0,0.00,30.86,9190,0
MEAR,9110,0,0.00,0,0.00,50.16,9010,100
OUSM,9108,0,0.00,0,0.00,42.70,8508,600
IGEB,9051,0,0.00,0,0.00,44.86,9051,0
OMFL,8886,0,0.00,0,0.00,54.20,8663,223
SECT,8805,0,0.00,0,0.00,53.42,8805,0
FLBL,8771,0,0.00,21,23.90,24.03,8771,0
GVI,8771,0,0.00,0,0.00,105.57,8564,207
DDWM,8719,0,0.00,200,37.20,37.46,8719,0
DIHP,8444,0,0.00,0,0.00,27.52,8444,0
GHYG,8180,0,0.00,0,0.00,44.92,8180,0
DFEB,7993,0,0.00,0,0.00,42.69,7993,0
IEO,7940,5,106.66,0,0.00,94.59,7940,0
DDLS,7917,0,0.00,0,0.00,36.36,7917,0
XAUG,7908,0,0.00,0,0.00,34.49,7908,0
MSFX,7882,700,22.20,300,22.13,22.20,7882,0
CBTJ,7861,0,0.00,0,0.00,23.89,7861,0
BBUS,7778,0,0.00,0,0.00,104.05,7778,0
GOOX,7721,83,25.12,400,24.91,25.01,7721,0
EZBC,7699,4100,50.97,4100,50.51,51.28,7499,200
NULG,7593,0,0.00,100,77.80,82.45,7295,298
ARKX,7542,1,19.80,6,19.15,19.11,7360,182
SMOT,7486,0,0.00,0,0.00,33.68,7486,0
FMAR,7184,0,0.00,16,42.70,42.88,7184,0
MAMB,7174,0,0.00,0,0.00,22.81,7174,0
SHYM,7116,0,0.00,0,0.00,22.70,7116,0
BTCO,6982,2600,87.86,2600,87.01,87.39,6982,0
ISPY,6913,10,43.50,9,39.21,43.29,6913,0
XMAY,6900,0,0.00,0,0.00,31.95,6900,0
TMFC,6898,0,0.00,9,55.54,57.87,6898,0
XSEP,6870,0,0.00,0,0.00,39.13,6870,0
ARKQ,6800,25,73.32,10,72.11,72.97,6800,0
CEFS,6757,6,22.50,50,21.50,21.92,6565,192
VCRM,6755,4,78.25,0,0.00,74.37,6755,0
GDE,6711,0,0.00,8,40.85,41.08,6689,22
SMB,6616,0,0.00,0,0.00,17.14,6616,0
JPLD,6551,0,0.00,0,0.00,51.89,6551,0
DISV,6517,0,0.00,0,0.00,29.97,6517,0
SPBU,6504,0,0.00,0,0.00,24.80,6504,0
SATO,6482,0,0.00,0,0.00,15.80,6482,0
FNOV,6375,0,0.00,0,0.00,47.53,6375,0
NULV,6346,100,44.15,100,36.76,40.48,6346,0
DMAX,6295,0,0.00,0,0.00,25.12,6295,0
BUFZ,6267,0,0.00,0,0.00,23.87,6267,0
DMAR,6263,0,0.00,0,0.00,38.12,6263,0
EMGF,6263,0,0.00,0,0.00,47.73,6263,0
XIDE,6234,0,0.00,0,0.00,30.11,6234,0
QVOY,6200,0,0.00,0,0.00,24.49,6200,0
DJUN,6103,0,0.00,0,0.00,42.89,6103,0
SMDV,6054,2,77.39,0,0.00,66.52,6054,0
TYA,6054,0,0.00,1,11.45,13.01,6054,0
NFLU,6026,2148,43.89,100,43.70,43.73,6026,0
NANC,5959,2,37.60,20,37.45,37.53,5959,0
SHYD,5841,0,0.00,0,0.00,22.71,5641,200
IYRI,5789,0,0.00,4,50.00,50.98,5689,100
HFGO,5771,0,0.00,0,0.00,22.11,5771,0
VSDM,5728,0,0.00,1,75.11,75.27,4944,784
JPIB,5713,0,0.00,0,0.00,47.84,5713,0
BTCL,5622,0,0.00,200,38.40,39.45,5622,0
IGRO,5309,0,0.00,0,0.00,73.48,3509,1800
VSGX,5272,0,0.00,0,0.00,60.58,5126,146
FLHY,5098,0,0.00,0,0.00,23.99,4844,254
RDTE,5048,1000,37.22,3,36.78,36.90,5048,0
ARKY,5039,0,0.00,0,0.00,28.98,5039,0
FFLG,5025,0,0.00,0,0.00,23.72,4938,87
IBHG,4900,0,0.00,0,0.00,22.41,4900,0
IETC,4890,5,80.17,0,0.00,80.03,4890,0
TMFE,4818,0,0.00,0,0.00,26.23,4818,0
FFLC,4808,350,46.35,300,43.00,45.19,4807,1
IVVB,4727,0,0.00,0,0.00,30.00,3427,1300
FIBR,4677,0,0.00,0,0.00,87.81,4677,0
XSHQ,4631,0,0.00,0,0.00,39.58,4631,0
UMAR,4582,0,0.00,0,0.00,36.04,4582,0
FDEM,4544,0,0.00,0,0.00,25.85,4544,0
MSSS,4520,0,0.00,0,0.00,27.87,4520,0
GSST,4439,0,0.00,0,0.00,50.48,4439,0
DRAG,4276,1,32.15,50,27.08,27.45,4276,0
IBHH,4207,0,0.00,0,0.00,23.49,4207,0
GARP,4177,0,0.00,0,0.00,54.18,4177,0
NUMV,4157,0,0.00,0,0.00,34.40,4157,0
FFSM,4110,0,0.00,0,0.00,26.09,4110,0
QBF,4053,0,0.00,0,0.00,23.00,4053,0
HYIN,4046,8,18.14,1,18.05,18.14,4046,0
MPRO,4037,0,0.00,0,0.00,29.05,4037,0
XJUL,4000,0,0.00,0,0.00,35.83,4000,0
IGE,3960,0,0.00,0,0.00,45.88,3960,0
SMMD,3950,0,0.00,0,0.00,64.85,3950,0
TMAR,3888,0,0.00,0,0.00,19.91,3888,0
INTL,3868,0,0.00,100,22.89,23.80,3868,0
FRDM,3792,0,0.00,3,36.36,36.43,3582,210
FAUG,3783,15,46.43,0,0.00,46.34,3783,0
RPHS,3752,0,0.00,0,0.00,9.88,3752,0
FLDR,3745,0,0.00,0,0.00,50.22,3745,0
EMHY,3733,0,0.00,14,38.25,38.53,3733,0
VFMV,3731,0,0.00,0,0.00,125.61,3731,0
IGLD,3681,0,0.00,1,20.40,20.44,3600,81
LQDI,3669,0,0.00,0,0.00,25.98,3669,0
AESR,3668,0,0.00,0,0.00,17.17,3668,0
EZET,3637,14000,15.69,11100,15.66,15.70,3637,0
BALI,3609,5,29.45,5,29.41,29.41,3609,0
IQDG,3582,0,0.00,0,0.00,37.03,3582,0
NUDV,3548,0,0.00,0,0.00,28.06,3548,0
SNOV,3524,0,0.00,0,0.00,22.58,3524,0
ACIO,3470,0,0.00,0,0.00,39.53,3470,0
EDGE,3450,0,0.00,0,0.00,38.02,3450,0
DAPR,3423,0,0.00,0,0.00,37.76,3423,0
PMAR,3423,0,0.00,0,0.00,40.59,3423,0
BSMC,3400,0,0.00,0,0.00,29.88,3400,0
MVFG,3389,0,0.00,0,0.00,25.19,3389,0
IGHG,3374,0,0.00,0,0.00,77.35,3374,0
HTUS,3311,0,0.00,0,0.00,37.39,3311,0
OSCV,3300,0,0.00,0,0.00,35.49,3300,0
SEIV,3282,0,0.00,0,0.00,33.15,3282,0
XMAR,3256,0,0.00,0,0.00,37.12,3256,0
DRSK,3220,0,0.00,0,0.00,27.95,3220,0
IBHK,3163,0,0.00,0,0.00,25.54,3163,0
WTAI,3124,1,32.26,1,20.11,20.85,3124,0
IBHE,3069,43,23.26,0,0.00,23.25,3069,0
MDPL,3046,0,0.00,0,0.00,26.06,3046,0
RSSB,3033,0,0.00,0,0.00,23.97,3033,0
XMPT,3008,18592,28.90,0,0.00,21.70,2716,292
FMAG,2972,0,0.00,0,0.00,30.42,2972,0
EYLD,2961,0,0.00,0,0.00,32.79,2961,0
ICLO,2957,200,25.51,200,25.37,25.49,2957,0
IBMP,2915,0,0.00,0,0.00,25.27,2915,0
VFMO,2898,0,0.00,0,0.00,159.66,2898,0
FCPI,2875,25,48.00,0,0.00,43.53,2875,0
JANZ,2871,0,0.00,0,0.00,33.85,2871,0
NVW,2826,700,41.07,700,40.00,40.41,2826,0
HEGD,2803,0,0.00,0,0.00,22.20,2803,0
BUFB,2748,0,0.00,0,0.00,32.14,2748,0
XJH,2724,0,0.00,0,0.00,40.20,2724,0
PJAN,2658,0,0.00,0,0.00,42.13,2442,216
PTMC,2640,0,0.00,0,0.00,34.55,2640,0
VTEI,2640,0,0.00,0,0.00,98.89,2640,0
IMFL,2582,0,0.00,0,0.00,25.21,2582,0
FYLD,2569,0,0.00,0,0.00,27.57,2569,0
OUSA,2561,12,55.00,0,0.00,53.08,2561,0
VFVA,2547,0,0.00,0,0.00,116.31,2547,0
PJUL,2512,0,0.00,0,0.00,41.00,2512,0
SAUG,2499,0,0.00,0,0.00,23.02,2499,0
PSDM,2489,0,0.00,0,0.00,51.07,2489,0
YMAR,2476,0,0.00,0,0.00,24.37,1720,756
QMFE,2473,0,0.00,0,0.00,19.55,2473,0
GAPR,2441,0,0.00,0,0.00,38.03,2441,0
FFEB,2431,0,0.00,0,0.00,49.85,2431,0
SFEB,2412,0,0.00,0,0.00,20.83,2412,0
ZALT,2412,0,0.00,0,0.00,29.75,2412,0
XJUN,2371,0,0.00,0,0.00,38.97,2371,0
DWLD,2333,0,0.00,0,0.00,39.02,2233,100
SVAL,2319,10,50.00,0,0.00,30.57,2319,0
ABFL,2310,0,0.00,0,0.00,66.34,2310,0
CETH,2270,22000,10.32,22000,10.30,10.37,2270,0
BBHY,2248,0,0.00,0,0.00,46.35,2248,0
UX,2246,0,0.00,0,0.00,23.33,2246,0
FEBM,2225,0,0.00,0,0.00,30.16,2225,0
PLTW,2178,700,35.88,1,35.12,35.85,2150,28
POCT,2150,0,0.00,0,0.00,39.48,2150,0
EALT,2103,0,0.00,0,0.00,31.67,2103,0
BMAR,2100,0,0.00,0,0.00,46.53,2100,0
NUDM,2096,0,0.00,0,0.00,32.80,2096,0
BGLD,2089,5,22.00,0,0.00,20.59,2089,0
DHDG,2081,0,0.00,0,0.00,30.42,2081,0
BAUG,2076,0,0.00,0,0.00,43.25,2076,0
MARM,2071,0,0.00,0,0.00,31.44,2071,0
PBP,2059,1,24.00,98,22.48,22.48,2059,0
FJUN,2042,0,0.00,0,0.00,50.98,2042,0
KHPI,2023,0,0.00,0,0.00,24.52,2023,0
FDRV,2020,0,0.00,10,11.46,14.04,2020,0
DUSA,2016,0,0.00,0,0.00,43.50,2016,0
GMOM,2012,0,0.00,0,0.00,28.80,2012,0
TSLP,2009,2,20.25,1,19.25,20.01,2009,0
PTEU,2006,0,0.00,0,0.00,28.20,2006,0
RBUF,2004,0,0.00,0,0.00,25.99,2004,0
GAA,2000,0,0.00,69,28.82,29.08,2000,0
GFEB,1988,0,0.00,0,0.00,37.40,1965,23
XDJL,1958,0,0.00,0,0.00,34.85,1958,0
IBMR,1936,0,0.00,0,0.00,25.01,1936,0
CSM,1935,0,0.00,0,0.00,65.88,1935,0
HSUN,1933,0,0.00,210,31.73,34.70,1933,0
NOVP,1900,0,0.00,0,0.00,27.10,1900,0
OVT,1900,0,0.00,0,0.00,22.31,1900,0
ATMP,1887,0,0.00,0,0.00,30.81,1887,0
NUEM,1866,0,0.00,0,0.00,29.89,1743,123
NUMG,1858,0,0.00,0,0.00,44.82,1858,0
UFEB,1844,0,0.00,0,0.00,32.85,1844,0
FLQL,1809,0,0.00,0,0.00,58.10,1809,0
DJAN,1789,0,0.00,0,0.00,38.50,1789,0
HEEM,1770,0,0.00,50,20.62,28.67,1770,0
QSPT,1765,0,0.00,0,0.00,27.45,1765,0
TMFS,1764,4,40.00,33,33.20,33.84,1764,0
CLSE,1752,10,22.30,0,0.00,22.12,1752,0
ABLD,1730,0,0.00,0,0.00,28.51,1730,0
LQDW,1714,100,26.61,5,26.14,26.24,1714,0
RBLU,1708,85,24.54,200,23.69,24.37,1708,0
BKGI,1703,0,0.00,200,34.20,34.33,1703,0
DDEC,1700,0,0.00,0,0.00,39.82,1700,0
FLIA,1685,0,0.00,0,0.00,20.12,1685,0
MOTI,1676,0,0.00,0,0.00,33.82,1676,0
FDEV,1632,0,0.00,0,0.00,29.71,1532,100
VXZ,1622,2,94.50,14,50.35,51.74,1622,0
XBJL,1587,0,0.00,0,0.00,34.45,1587,0
FHEQ,1583,0,0.00,0,0.00,26.96,1583,0
VFMF,1578,0,0.00,0,0.00,129.53,1578,0
GDEC,1577,0,0.00,0,0.00,33.65,1577,0
UJAN,1563,0,0.00,0,0.00,38.76,1563,0
COIW,1562,0,0.00,700,33.91,34.86,1562,0
MAGA,1558,10,54.10,0,0.00,48.49,1558,0
HCRB,1557,0,0.00,0,0.00,35.06,1557,0
OMFS,1553,0,0.00,0,0.00,38.53,1553,0
DJTU,1549,402,22.64,103,21.69,22.64,1549,0
HYHG,1547,12,65.50,0,0.00,64.96,1547,0
UAUG,1545,0,0.00,0,0.00,35.28,1545,0
JXX,1526,0,0.00,0,0.00,23.50,1526,0
IBHJ,1524,0,0.00,0,0.00,26.29,1524,0
ZJAN,1510,0,0.00,0,0.00,25.66,1510,0
QSIG,1506,0,0.00,0,0.00,48.49,1506,0
TDV,1494,0,0.00,0,0.00,75.14,1494,0
QCJA,1489,0,0.00,0,0.00,19.60,1489,0
FFOG,1468,0,0.00,0,0.00,37.41,1468,0
HSRT,1468,0,0.00,200,38.81,38.97,1468,0
TAIL,1459,0,0.00,0,0.00,11.36,1459,0
BUFF,1455,0,0.00,0,0.00,44.89,1455,0
XDEC,1455,0,0.00,0,0.00,37.37,1455,0
IBMO,1441,0,0.00,0,0.00,25.56,1441,0
FPAS,1420,0,0.00,0,0.00,25.09,1420,0
SEIQ,1420,0,0.00,0,0.00,35.21,1420,0
BUFG,1416,0,0.00,0,0.00,24.29,1416,0
RSST,1410,0,0.00,0,0.00,22.85,1410,0
FCLD,1407,0,0.00,0,0.00,25.95,1407,0
EVLU,1405,0,0.00,0,0.00,26.31,1405,0
DAUG,1402,0,0.00,0,0.00,39.50,1402,0
HYGW,1372,100,32.44,100,30.50,31.61,1372,0
RSBA,1357,0,0.00,0,0.00,20.47,1357,0
EPRF,1350,0,0.00,0,0.00,18.21,1350,0
STOT,1347,0,0.00,0,0.00,47.15,1347,0
QJUN,1339,0,0.00,0,0.00,27.46,1339,0
ETU,1334,500,12.23,400,11.86,12.22,1334,0
MBCC,1315,0,0.00,0,0.00,34.51,1315,0
BEMB,1311,0,0.00,5,49.96,52.53,1311,0
OVM,1296,0,0.00,0,0.00,21.52,1296,0
AAPY,1289,0,0.00,0,0.00,23.54,1289,0
EMTL,1271,64,43.40,0,0.00,43.01,1271,0
BAPR,1255,0,0.00,0,0.00,43.64,1255,0
WEEK,1250,0,0.00,0,0.00,100.03,1250,0
TMAT,1242,0,0.00,0,0.00,19.58,1242,0
GJUN,1212,0,0.00,0,0.00,35.93,1212,0
GSUS,1211,0,0.00,0,0.00,79.35,1211,0
EAOA,1206,0,0.00,2,33.00,36.19,1206,0
KAPR,1195,0,0.00,0,0.00,31.02,1195,0
FPAG,1192,0,0.00,0,0.00,31.17,1192,0
BNOV,1191,0,0.00,0,0.00,39.01,1191,0
NURE,1184,0,0.00,0,0.00,31.14,1184,0
BUFS,1148,0,0.00,0,0.00,20.70,1148,0
BRLN,1145,200,51.80,200,51.60,51.69,1145,0
DOCT,1140,0,0.00,0,0.00,39.00,1140,0
GOCT,1139,0,0.00,0,0.00,34.91,1139,0
XEMD,1139,0,0.00,0,0.00,42.39,1139,0
PIT,1137,0,0.00,0,0.00,50.28,1137,0
FBCV,1124,0,0.00,0,0.00,32.02,1124,0
TJUL,1109,0,0.00,1,28.11,28.19,1109,0
NMAR,1107,0,0.00,0,0.00,26.05,1107,0
IBMN,1104,0,0.00,0,0.00,26.72,1104,0
VCEB,1104,0,0.00,0,0.00,62.76,1104,0
HSBH,1101,0,0.00,0,0.00,65.45,1101,0
JAJL,1101,0,0.00,0,0.00,27.30,1101,0
GHMS,1100,0,0.00,0,0.00,25.95,1100,0
UJUN,1100,0,0.00,0,0.00,33.84,1100,0
DUBS,1091,0,0.00,0,0.00,31.91,1091,0
GOLY,1087,1,29.00,17,24.04,26.64,1087,0
IBMS,1087,0,0.00,0,0.00,25.41,1087,0
QHY,1082,0,0.00,0,0.00,45.64,1082,0
ZFEB,1081,0,0.00,0,0.00,23.76,1081,0
HYXU,1073,0,0.00,0,0.00,49.37,1073,0
EDEN,1066,0,0.00,1,54.56,107.48,666,400
RDFI,1061,0,0.00,0,0.00,23.77,1061,0
JEMA,1045,0,0.00,0,0.00,39.37,1045,0
UOCT,1042,0,0.00,0,0.00,35.14,1042,0
PFEB,1040,0,0.00,0,0.00,36.46,1040,0
BJAN,1026,0,0.00,0,0.00,47.56,1026,0
NJAN,1024,0,0.00,100,43.27,47.64,1024,0
NOCT,1024,0,0.00,0,0.00,51.01,1024,0
YSEP,1020,0,0.00,0,0.00,23.13,1020,0
SHEH,1010,0,0.00,0,0.00,52.96,1010,0
KMAR,1005,0,0.00,0,0.00,25.34,1005,0
KAUG,1000,0,0.00,0,0.00,24.46,1000,0
TYLD,990,0,0.00,0,0.00,25.29,990,0
OVS,979,0,0.00,0,0.00,32.54,979,0
TDVI,979,0,0.00,1,22.39,23.38,979,0
TOLL,967,0,0.00,0,0.00,32.74,967,0
AOCT,963,0,0.00,0,0.00,25.03,963,0
GJUL,962,0,0.00,0,0.00,36.62,962,0
DSEP,954,0,0.00,0,0.00,40.30,954,0
GJAN,953,0,0.00,0,0.00,38.34,953,0
BBRE,949,0,0.00,11,90.28,93.07,949,0
OVF,934,0,0.00,0,0.00,25.70,934,0
ENOR,930,0,0.00,56,21.75,26.27,930,0
SMMV,920,0,0.00,0,0.00,41.47,920,0
MVFD,912,0,0.00,0,0.00,25.80,912,0
IPAV,911,0,0.00,0,0.00,25.29,911,0
BFEB,908,0,0.00,0,0.00,42.40,908,0
LAPR,900,0,0.00,0,0.00,25.09,900,0
DFNL,869,1,40.80,7,39.93,40.05,593,276
JUNM,850,0,0.00,0,0.00,31.81,850,0
IDUB,847,0,0.00,0,0.00,21.45,847,0
TJAN,840,0,0.00,0,0.00,25.52,840,0
ZVOL,833,1011,19.89,1,16.00,17.34,832,1
AMZP,832,0,0.00,1,27.92,28.28,832,0
PDEC,832,0,0.00,0,0.00,38.20,832,0
FDGR,831,0,0.00,0,0.00,13.26,831,0
ITWO,826,0,0.00,0,0.00,37.49,826,0
IVVM,808,0,0.00,0,0.00,30.66,808,0
PSEP,808,0,0.00,0,0.00,39.03,808,0
KJAN,807,0,0.00,0,0.00,36.60,807,0
UAPR,801,0,0.00,0,0.00,30.76,801,0
DJUL,800,0,0.00,0,0.00,41.71,800,0
FMAY,799,0,0.00,0,0.00,47.21,799,0
SEIM,786,0,0.00,0,0.00,37.82,786,0
EZPZ,778,0,0.00,0,0.00,22.15,778,0
PJUN,777,0,0.00,0,0.00,37.66,777,0
BUFT,775,0,0.00,0,0.00,22.77,775,0
NFLP,771,0,0.00,10,35.06,35.84,771,0
BUFY,770,0,0.00,0,0.00,20.11,770,0
FPRO,754,0,0.00,0,0.00,22.69,754,0
QETH,754,10000,20.61,10000,20.57,20.73,754,0
XBOC,752,0,0.00,0,0.00,30.28,752,0
GDMN,745,0,0.00,0,0.00,41.51,745,0
FPFD,742,0,0.00,100,21.41,21.67,742,0
NDOW,734,0,0.00,0,0.00,24.80,734,0
OILK,733,600,43.33,600,42.03,42.51,733,0
RSSY,724,0,0.00,0,0.00,17.93,690,34
NVOH,723,0,0.00,0,0.00,42.00,723,0
AZNH,700,1,46.63,0,0.00,45.85,700,0
XDQQ,697,0,0.00,0,0.00,33.46,697,0
UPSD,689,0,0.00,0,0.00,23.75,689,0
FDEC,686,0,0.00,0,0.00,44.24,686,0
SMAX,684,0,0.00,0,0.00,25.29,684,0
JUCY,678,0,0.00,0,0.00,22.92,678,0
YJUN,675,0,0.00,0,0.00,23.26,675,0
FJUL,674,0,0.00,0,0.00,48.59,674,0
GNOV,673,0,0.00,0,0.00,34.90,673,0
KWT,673,0,0.00,0,0.00,35.69,673,0
GOP,663,494,31.92,1,30.00,31.69,663,0
PMAY,657,0,0.00,0,0.00,36.36,657,0
QUVU,636,0,0.00,0,0.00,25.19,636,0
QLC,635,0,0.00,3,57.88,65.71,635,0
QTOC,632,0,0.00,0,0.00,29.01,632,0
OEUR,626,0,0.00,100,29.61,30.69,626,0
GROZ,621,0,0.00,0,0.00,23.51,621,0
RSBT,621,0,0.00,0,0.00,16.83,621,0
QCOC,606,0,0.00,0,0.00,20.10,606,0
VEGN,601,0,0.00,0,0.00,51.49,601,0
DURA,600,0,0.00,0,0.00,33.85,600,0
PSFJ,590,0,0.00,0,0.00,29.00,590,0
DNOV,578,0,0.00,0,0.00,42.57,578,0
PAPR,578,0,0.00,0,0.00,36.62,578,0
TMFG,568,132,46.05,0,0.00,28.54,568,0
IVRA,557,0,0.00,0,0.00,16.11,557,0
CBOJ,552,12,24.99,0,0.00,24.90,552,0
TMFM,538,10,27.22,0,0.00,25.67,538,0
EFNL,537,0,0.00,0,0.00,38.02,537,0
STHH,531,0,0.00,0,0.00,51.14,531,0
PRNT,521,3,22.00,15,18.50,20.53,521,0
ZECP,521,0,0.00,0,0.00,30.35,521,0
PAUG,519,0,0.00,0,0.00,38.44,519,0
CBXJ,513,0,0.00,0,0.00,24.45,513,0
BINV,508,0,0.00,0,0.00,33.86,508,0
GVAL,506,0,0.00,0,0.00,24.97,506,0
FCTR,500,0,0.00,0,0.00,31.85,500,0
GBXC,500,0,0.00,0,0.00,24.47,500,0
IEDI,500,0,0.00,0,0.00,51.57,500,0
QMNV,500,0,0.00,0,0.00,20.11,500,0
STBF,500,0,0.00,0,0.00,25.27,500,0
XIMR,500,0,0.00,0,0.00,30.91,500,0
GSKH,499,0,0.00,0,0.00,55.43,499,0
BAMB,484,0,0.00,0,0.00,26.03,484,0
DECP,483,0,0.00,0,0.00,26.31,483,0
CNAV,481,0,0.00,0,0.00,24.54,481,0
FFGX,481,0,0.00,0,0.00,26.60,481,0
TSW,481,700,37.85,700,36.29,37.23,481,0
LYLD,478,0,0.00,5,24.01,26.01,478,0
SMAY,471,0,0.00,0,0.00,23.93,471,0
QBER,468,0,0.00,0,0.00,24.66,468,0
JCPI,463,0,0.00,0,0.00,47.79,463,0
URAN,445,2,36.95,1,27.70,28.04,445,0
GMAY,441,0,0.00,0,0.00,37.00,441,0
MSTB,437,0,0.00,0,0.00,33.21,437,0
NAPR,435,0,0.00,0,0.00,49.98,435,0
MDLV,430,0,0.00,0,0.00,27.10,430,0
DINT,417,0,0.00,0,0.00,23.83,317,100
ISVL,415,0,0.00,0,0.00,38.08,415,0
EFAD,411,0,0.00,0,0.00,39.46,411,0
IBMQ,410,0,0.00,0,0.00,25.26,410,0
GSEE,409,0,0.00,0,0.00,46.05,409,0
XDAP,402,0,0.00,0,0.00,36.47,402,0
XISE,401,0,0.00,0,0.00,30.25,401,0
ZMAR,401,0,0.00,0,0.00,25.89,401,0
FFDI,400,0,0.00,0,0.00,27.42,400,0
OGIG,400,0,0.00,0,0.00,47.16,400,0
QDEC,381,0,0.00,0,0.00,27.15,381,0
LIMI,380,0,0.00,0,0.00,24.50,380,0
XUSP,371,0,0.00,0,0.00,38.72,371,0
ZDEK,364,0,0.00,0,0.00,23.86,364,0
XIJN,362,0,0.00,0,0.00,30.74,362,0
BUYZ,360,0,0.00,0,0.00,36.40,360,0
MFUL,360,0,0.00,0,0.00,21.66,360,0
AAPR,359,0,0.00,0,0.00,26.41,359,0
PEX,359,0,0.00,0,0.00,28.16,359,0
RULE,353,0,0.00,0,0.00,21.03,353,0
BDEC,352,0,0.00,0,0.00,42.67,252,100
FAPR,348,0,0.00,0,0.00,41.82,348,0
GLOV,347,0,0.00,0,0.00,51.83,347,0
SELV,331,0,0.00,0,0.00,30.30,331,0
BJUL,326,0,0.00,0,0.00,44.18,326,0
PSFF,320,0,0.00,0,0.00,29.08,320,0
GHTA,314,2,57.08,0,0.00,30.02,314,0
XJR,312,0,0.00,0,0.00,38.61,312,0
VAMO,309,0,0.00,0,0.00,29.28,309,0
MYLD,308,0,0.00,0,0.00,23.00,308,0
WEED,307,0,0.00,0,0.00,10.93,307,0
ZJUL,307,0,0.00,0,0.00,27.09,307,0
BAMD,303,0,0.00,0,0.00,31.77,303,0
OVB,300,0,0.00,0,0.00,20.67,300,0
SHDG,300,0,0.00,0,0.00,28.60,300,0
TFJL,300,0,0.00,0,0.00,20.47,300,0
TSEP,300,0,0.00,0,0.00,20.56,300,0
TUSI,300,0,0.00,0,0.00,25.43,300,0
LKOR,288,0,0.00,0,0.00,42.36,288,0
ADFI,281,0,0.00,210,5.55,8.47,281,0
SNPG,274,0,0.00,1,43.41,43.71,274,0
ROMO,271,0,0.00,0,0.00,31.18,271,0
QBUL,266,0,0.00,0,0.00,24.82,266,0
JANH,261,0,0.00,0,0.00,24.84,261,0
PBTP,255,0,0.00,0,0.00,25.83,255,0
UXOC,253,0,0.00,0,0.00,29.60,253,0
RSEE,252,0,0.00,0,0.00,28.83,252,0
XNOV,248,0,0.00,0,0.00,34.25,248,0
PBFR,247,0,0.00,0,0.00,26.55,247,0
ISMF,241,0,0.00,0,0.00,25.23,241,0
QCON,236,0,0.00,0,0.00,45.39,236,0
BLDG,225,0,0.00,9,23.53,23.85,225,0
NJUL,222,0,0.00,0,0.00,61.97,222,0
SEPM,222,0,0.00,0,0.00,29.91,222,0
IQM,220,0,0.00,0,0.00,61.59,220,0
MIG,219,0,0.00,0,0.00,21.29,219,0
GAUG,218,0,0.00,0,0.00,35.33,218,0
ARKZ,210,0,0.00,0,0.00,22.59,210,0
MARZ,210,0,0.00,0,0.00,30.94,210,0
PNOV,210,0,0.00,0,0.00,37.84,210,0
QPFF,209,0,0.00,0,0.00,35.81,209,0
TLTP,208,0,0.00,0,0.00,23.87,208,0
JULZ,207,0,0.00,0,0.00,40.96,207,0
NSEP,207,0,0.00,0,0.00,25.57,207,0
IYLD,205,0,0.00,0,0.00,20.27,205,0
JANJ,204,0,0.00,0,0.00,24.87,204,0
ADME,200,0,0.00,0,0.00,45.61,200,0
JULJ,200,0,0.00,0,0.00,25.20,200,0
KFEB,200,0,0.00,0,0.00,24.40,200,0
PBDE,200,0,0.00,0,0.00,26.32,200,0
PIEQ,200,0,0.00,0,0.00,27.20,200,0
NJUN,199,0,0.00,0,0.00,27.12,199,0
DMAY,196,0,0.00,0,0.00,40.57,196,0
IZRL,195,0,0.00,200,21.21,22.66,195,0
NNOV,194,0,0.00,0,0.00,25.67,194,0
EWUS,193,0,0.00,0,0.00,35.64,193,0
XFEB,192,0,0.00,0,0.00,32.63,192,0
XVOL,187,0,0.00,0,0.00,20.39,187,0
PAWZ,184,0,0.00,1,51.40,52.18,84,100
TOKE,182,22,5.25,0,0.00,4.51,182,0
MSFY,178,0,0.00,0,0.00,23.20,178,0
FEBU,176,0,0.00,0,0.00,24.43,176,0
IVVW,173,80,47.28,0,0.00,47.27,173,0
QTJL,171,0,0.00,0,0.00,32.20,171,0
VFQY,169,0,0.00,0,0.00,136.94,169,0
FRNW,164,0,0.00,0,0.00,13.49,164,0
NULC,160,0,0.00,0,0.00,45.15,160,0
DOGG,153,0,0.00,25,20.25,20.47,153,0
ARLU,151,0,0.00,0,0.00,26.63,151,0
BWTG,150,0,0.00,0,0.00,37.00,150,0
BSEP,147,0,0.00,0,0.00,42.69,147,0
GSEP,147,0,0.00,0,0.00,35.04,147,0
AAPW,143,0,0.00,0,0.00,44.12,143,0
BAMA,140,0,0.00,0,0.00,30.38,140,0
BAMG,138,0,0.00,0,0.00,33.22,102,36
GTIP,138,0,0.00,0,0.00,49.57,138,0
IDVZ,137,0,0.00,0,0.00,27.71,137,0
ZAUG,134,0,0.00,0,0.00,24.90,134,0
MSMR,131,0,0.00,0,0.00,29.93,131,0
TLTI,131,0,0.00,5,47.60,47.67,131,0
CPSL,128,0,0.00,0,0.00,25.64,128,0
UJUL,123,0,0.00,0,0.00,34.20,123,0
QCJL,121,0,0.00,0,0.00,20.86,121,0
MOTG,119,0,0.00,0,0.00,39.75,119,0
YDEC,118,0,0.00,0,0.00,24.09,118,0
HAUS,117,0,0.00,0,0.00,19.31,117,0
QMMY,115,0,0.00,0,0.00,21.50,115,0
MBNE,114,0,0.00,0,0.00,29.45,114,0
TMH,114,0,0.00,0,0.00,53.32,114,0
AFIF,113,0,0.00,0,0.00,9.23,113,0
ONEZ,110,0,0.00,0,0.00,24.06,110,0
FYEE,109,0,0.00,0,0.00,25.80,109,0
EUDV,104,0,0.00,0,0.00,50.01,104,0
ASMH,102,0,0.00,0,0.00,52.60,102,0
IWMW,102,328,46.50,0,0.00,41.74,102,0
AJAN,100,0,0.00,0,0.00,26.45,100,0
APRJ,100,0,0.00,0,0.00,24.84,100,0
BAMU,100,0,0.00,0,0.00,25.28,100,0
BPH,100,0,0.00,0,0.00,54.81,100,0
FLQS,100,0,0.00,0,0.00,39.97,100,0
GDMA,100,0,0.00,0,0.00,32.32,100,0
KJUL,100,0,0.00,0,0.00,28.61,100,0
LOCT,100,0,0.00,0,0.00,23.84,100,0
MARU,100,0,0.00,0,0.00,24.46,100,0
MBND,100,0,0.00,0,0.00,27.31,100,0
MILK,100,0,0.00,0,0.00,24.68,100,0
OCTU,100,0,0.00,0,0.00,25.05,100,0
PIPE,100,0,0.00,0,0.00,25.72,100,0
SAPH,100,0,0.00,0,0.00,54.50,100,0
TGLR,100,0,0.00,0,0.00,29.55,100,0
TMDV,100,0,0.00,0,0.00,47.17,100,0
USEP,100,0,0.00,0,0.00,35.06,100,0
XDSQ,100,0,0.00,0,0.00,35.78,100,0
XTOC,100,0,0.00,0,0.00,29.31,100,0
ZNOV,100,0,0.00,0,0.00,25.20,100,0
BLKC,99,0,0.00,0,0.00,20.59,99,0
PSMJ,81,0,0.00,0,0.00,28.36,81,0
QIG,80,0,0.00,0,0.00,44.38,80,0
SEPU,78,0,0.00,0,0.00,25.42,78,0
FEBP,77,0,0.00,0,0.00,28.04,77,0
NFEB,77,0,0.00,0,0.00,24.36,77,0
EVUS,73,0,0.00,0,0.00,29.33,73,0
MAYU,71,0,0.00,0,0.00,27.82,71,0
OCTQ,70,0,0.00,0,0.00,24.17,70,0
SPIN,69,0,0.00,0,0.00,30.03,69,0
OCTJ,64,0,0.00,0,0.00,24.22,64,0
TMFX,63,0,0.00,0,0.00,19.08,63,0
HIYS,60,0,0.00,0,0.00,25.34,60,0
NOVZ,60,0,0.00,0,0.00,39.70,60,0
MAXJ,57,0,0.00,50,24.00,26.13,57,0
TBJL,54,0,0.00,0,0.00,20.09,54,0
BOXA,53,0,0.00,0,0.00,101.97,53,0
NDEC,50,0,0.00,0,0.00,24.22,50,0
VWID,50,0,0.00,0,0.00,29.98,50,0
WLDR,50,0,0.00,0,0.00,30.00,50,0
BJUN,48,0,0.00,0,0.00,41.35,48,0
FDCE,48,0,0.00,0,0.00,12.32,48,0
BBLB,47,0,0.00,0,0.00,85.16,47,0
GOOP,39,1,28.68,100,24.05,25.88,39,0
BCHP,38,0,0.00,0,0.00,33.58,38,0
ARKD,34,0,0.00,100,29.30,40.14,34,0
OCTH,33,0,0.00,0,0.00,24.24,33,0
JULQ,28,0,0.00,0,0.00,25.13,28,0
BOCT,24,0,0.00,0,0.00,42.95,24,0
BMAY,23,0,0.00,0,0.00,40.52,23,0
ARKC,21,0,0.00,0,0.00,33.89,21,0
BEGS,19,0,0.00,0,0.00,22.27,19,0
ESG,19,2,138.51,0,0.00,137.50,19,0
LEAD,18,0,0.00,0,0.00,65.60,18,0
WUGI,18,0,0.00,0,0.00,70.91,18,0
AJUL,15,0,0.00,0,0.00,26.96,15,0
BBEM,15,0,0.00,0,0.00,53.87,15,0
EAOK,15,0,0.00,0,0.00,25.90,15,0
PUTD,15,0,0.00,0,0.00,20.35,15,0
SNAV,15,0,0.00,0,0.00,29.96,15,0
TILT,14,0,0.00,1,177.54,211.29,14,0
DFND,13,0,0.00,1,41.15,41.55,13,0
GEMD,13,0,0.00,0,0.00,40.56,13,0
APRP,12,0,0.00,0,0.00,27.46,12,0
ARMU,10,277,25.85,277,25.07,25.15,10,0
IPDP,10,1,23.00,0,0.00,19.57,10,0
WBAT,10,0,0.00,0,0.00,27.85,10,0
XTJA,10,0,0.00,0,0.00,27.54,10,0
ETQ,9,200,17.93,300,17.30,17.58,9,0
GSID,9,0,0.00,0,0.00,59.77,9,0
MDEV,9,0,0.00,0,0.00,20.48,9,0
OVLH,9,0,0.00,0,0.00,33.71,9,0
BBSB,8,0,0.00,0,0.00,98.72,8,0
IPPP,8,0,0.00,0,0.00,10.06,8,0
MRCP,8,0,0.00,0,0.00,28.45,8,0
MGRO,7,0,0.00,0,0.00,29.18,7,0
CORX,6,0,0.00,0,0.00,15.97,6,0
EGUS,6,0,0.00,0,0.00,41.83,6,0
ARKA,5,0,0.00,0,0.00,56.72,5,0
KJUN,5,0,0.00,0,0.00,26.05,5,0
BUSA,3,0,0.00,0,0.00,33.05,3,0
CAOS,3,0,0.00,0,0.00,88.10,3,0
HEAT,3,0,0.00,0,0.00,25.79,3,0
MVAL,3,0,0.00,0,0.00,31.92,3,0
SNPD,3,0,0.00,0,0.00,26.00,3,0
BBIB,2,0,0.00,0,0.00,98.01,2,0
DECZ,2,0,0.00,0,0.00,36.46,2,0
ESGG,2,0,0.00,0,0.00,174.43,2,0
FBUF,2,0,0.00,0,0.00,27.04,2,0
GBXA,2,0,0.00,0,0.00,24.55,2,0
JANU,2,0,0.00,0,0.00,24.70,2,0
MINN,2,0,0.00,0,0.00,21.96,2,0
ABHY,1,0,0.00,0,0.00,19.15,1,0
DWAT,1,0,0.00,0,0.00,11.99,1,0
DWCR,1,0,0.00,0,0.00,30.52,1,0
FDHT,1,0,0.00,0,0.00,21.11,1,0
LFDR,1,0,0.00,0,0.00,180.35,1,0
OCTD,1,0,0.00,0,0.00,24.14,1,0
RYSE,1,0,0.00,0,0.00,23.85,1,0
SMI,1,0,0.00,0,0.00,45.47,1,0
UXJA,1,0,0.00,0,0.00,28.54,1,0
WHTX,1,0,0.00,0,0.00,13.90,1,0
ZSEP,1,0,0.00,0,0.00,25.16,1,0
ABLG,0,0,0.00,0,0.00,0.00,0,0
ABLS,0,0,0.00,0,0.00,0.00,0,0
ABOT,0,0,0.00,0,0.00,0.00,0,0
ACSI,0,0,0.00,0,0.00,0.00,0,0
APOC,0,0,0.00,0,0.00,0.00,0,0
APRD,0,0,0.00,0,0.00,0.00,0,0
APRH,0,0,0.00,0,0.00,0.00,0,0
APRQ,0,0,0.00,0,0.00,0.00,0,0
APRZ,0,0,0.00,0,0.00,0.00,0,0
AQLT,0,0,0.00,0,0.00,0.00,0,0
ARCM,0,0,0.00,0,0.00,0.00,0,0
ARMH,0,0,0.00,0,0.00,0.00,0,0
AUGM,0,0,0.00,0,0.00,0.00,0,0
AUGP,0,0,0.00,0,0.00,0.00,0,0
AUGU,0,0,0.00,0,0.00,0.00,0,0
AUGZ,0,0,0.00,0,0.00,0.00,0,0
BAMO,0,0,0.00,0,0.00,0.00,0,0
BAMV,0,0,0.00,0,0.00,0.00,0,0
BAMY,0,0,0.00,0,0.00,0.00,0,0
BHYB,0,0,0.00,0,0.00,0.00,0,0
BUFP,0,0,0.00,0,0.00,0.00,0,0
CMCI,0,0,0.00,0,0.00,0.00,0,0
COPA,0,0,0.00,0,0.00,0.00,0,0
CVAR,0,0,0.00,0,0.00,0.00,0,0
DECM,0,0,0.00,0,0.00,0.00,0,0
DECU,0,0,0.00,0,0.00,0.00,0,0
DSCF,0,0,0.00,0,0.00,0.00,0,0
EAOM,0,0,0.00,0,0.00,0.00,0,0
EAOR,0,0,0.00,0,0.00,0.00,0,0
EATV,0,0,0.00,0,0.00,0.00,0,0
EMDV,0,0,0.00,0,0.00,0.00,0,0
EQLT,0,0,0.00,0,0.00,0.00,0,0
FDND,0,0,0.00,0,0.00,0.00,0,0
FDTB,0,0,0.00,0,0.00,0.00,0,0
FDVL,0,0,0.00,0,0.00,0.00,0,0
FEBZ,0,0,0.00,0,0.00,0.00,0,0
FFEM,0,0,0.00,0,0.00,0.00,0,0
FFLV,0,0,0.00,0,0.00,0.00,0,0
FHDG,0,0,0.00,0,0.00,0.00,0,0
FLDZ,0,0,0.00,0,0.00,0.00,0,0
FOWF,0,0,0.00,0,0.00,0.00,0,0
FUNL,0,0,0.00,0,0.00,0.00,0,0
GBXB,0,0,0.00,0,0.00,0.00,0,0
GLBL,0,0,0.00,0,0.00,0.00,0,0
GTOS,0,0,0.00,210,22.03,0.00,0,0
GUNZ,0,0,0.00,0,0.00,0.00,0,0
HAPR,0,0,0.00,0,0.00,0.00,0,0
HBTC,0,0,0.00,0,0.00,0.00,0,0
HELX,0,0,0.00,0,0.00,0.00,0,0
HJUL,0,0,0.00,0,0.00,0.00,0,0
HOCT,0,0,0.00,0,0.00,0.00,0,0
HYKE,0,0,0.00,0,0.00,0.00,0,0
IMF,0,0,0.00,0,0.00,0.00,0,0
IROC,0,0,0.00,0,0.00,0.00,0,0
JANM,0,0,0.00,0,0.00,0.00,0,0
JANP,0,0,0.00,0,0.00,0.00,0,0
JNEU,0,0,0.00,0,0.00,0.00,0,0
JULD,0,0,0.00,0,0.00,0.00,0,0
JULH,0,0,0.00,0,0.00,0.00,0,0
JULM,0,0,0.00,0,0.00,0.00,0,0
JULP,0,0,0.00,0,0.00,0.00,0,0
JULU,0,0,0.00,0,0.00,0.00,0,0
JUNP,0,0,0.00,0,0.00,0.00,0,0
JUNZ,0,0,0.00,0,0.00,0.00,0,0
KDEC,0,0,0.00,0,0.00,0.00,0,0
KNOV,0,0,0.00,0,0.00,0.00,0,0
KNOW,0,0,0.00,0,0.00,0.00,0,0
KOCT,0,0,0.00,0,0.00,0.00,0,0
KSEP,0,0,0.00,0,0.00,0.00,0,0
LBO,0,0,0.00,0,0.00,0.00,0,0
LCF,0,0,0.00,0,0.00,0.00,0,0
LDDR,0,0,0.00,0,0.00,0.00,0,0
LDER,0,0,0.00,0,0.00,0.00,0,0
LDRR,0,0,0.00,0,0.00,0.00,0,0
LENS,0,0,0.00,0,0.00,0.00,0,0
LFAE,0,0,0.00,0,0.00,0.00,0,0
LFAF,0,0,0.00,0,0.00,0.00,0,0
LFAI,0,0,0.00,0,0.00,0.00,0,0
LFAJ,0,0,0.00,0,0.00,0.00,0,0
LFAK,0,0,0.00,0,0.00,0.00,0,0
LFAL,0,0,0.00,0,0.00,0.00,0,0
LFAN,0,0,0.00,0,0.00,0.00,0,0
LFAO,0,0,0.00,0,0.00,0.00,0,0
LFAQ,0,0,0.00,0,0.00,0.00,0,0
LFAR,0,0,0.00,0,0.00,0.00,0,0
LFAU,0,0,0.00,0,0.00,0.00,0,0
LFAV,0,0,0.00,0,0.00,0.00,0,0
LFAW,0,0,0.00,0,0.00,0.00,0,0
LFAX,0,0,0.00,0,0.00,0.00,0,0
LFAZ,0,0,0.00,0,0.00,0.00,0,0
LFBB,0,0,0.00,0,0.00,0.00,0,0
LFBD,0,0,0.00,0,0.00,0.00,0,0
LFBE,0,0,0.00,0,0.00,0.00,0,0
LIAB,0,0,0.00,0,0.00,0.00,0,0
LIAC,0,0,0.00,0,0.00,0.00,0,0
LIAE,0,0,0.00,0,0.00,0.00,0,0
LIAF,0,0,0.00,0,0.00,0.00,0,0
LIAG,0,0,0.00,0,0.00,0.00,0,0
LIAJ,0,0,0.00,0,0.00,0.00,0,0
LIAK,0,0,0.00,0,0.00,0.00,0,0
LIAM,0,0,0.00,0,0.00,0.00,0,0
LIAO,0,0,0.00,0,0.00,0.00,0,0
LIAP,0,0,0.00,0,0.00,0.00,0,0
LIAQ,0,0,0.00,0,0.00,0.00,0,0
LIAT,0,0,0.00,0,0.00,0.00,0,0
LIAU,0,0,0.00,0,0.00,0.00,0,0
LIAV,0,0,0.00,0,0.00,0.00,0,0
LIAW,0,0,0.00,0,0.00,0.00,0,0
LIAX,0,0,0.00,0,0.00,0.00,0,0
LIAY,0,0,0.00,0,0.00,0.00,0,0
LIBD,0,0,0.00,0,0.00,0.00,0,0
LJAN,0,0,0.00,0,0.00,0.00,0,0
LJUL,0,0,0.00,0,0.00,0.00,0,0
MAYP,0,0,0.00,0,0.00,0.00,0,0
MAYZ,0,0,0.00,0,0.00,0.00,0,0
MBBB,0,0,0.00,0,0.00,0.00,0,0
MFUT,0,0,0.00,0,0.00,0.00,0,0
MOTE,0,0,0.00,0,0.00,0.00,0,0
MRGR,0,0,0.00,0,0.00,0.00,0,0
MSTQ,0,0,0.00,0,0.00,0.00,0,0
NAUG,0,0,0.00,0,0.00,0.00,0,0
NOVM,0,0,0.00,0,0.00,0.00,0,0
NVBU,0,0,0.00,0,0.00,0.00,0,0
NXTI,0,0,0.00,0,0.00,0.00,0,0
NXTV,0,0,0.00,0,0.00,0.00,0,0
OBND,0,0,0.00,0,0.00,0.00,0,0
OCTM,0,0,0.00,0,0.00,0.00,0,0
OCTP,0,0,0.00,0,0.00,0.00,0,0
OCTZ,0,0,0.00,0,0.00,0.00,0,0
PBAP,0,0,0.00,0,0.00,0.00,0,0
PBAU,0,0,0.00,0,0.00,0.00,0,0
PBFB,0,0,0.00,0,0.00,0.00,0,0
PBJA,0,0,0.00,0,0.00,0.00,0,0
PBJL,0,0,0.00,0,0.00,0.00,0,0
PBJN,0,0,0.00,0,0.00,0.00,0,0
PBL,0,0,0.00,0,0.00,0.00,0,0
PBMR,0,0,0.00,0,0.00,0.00,0,0
PBMY,0,0,0.00,0,0.00,0.00,0,0
PBNV,0,0,0.00,0,0.00,0.00,0,0
PBOC,0,0,0.00,0,0.00,0.00,0,0
PBSE,0,0,0.00,0,0.00,0.00,0,0
PJBF,0,0,0.00,0,0.00,0.00,0,0
PJFM,0,0,0.00,0,0.00,0.00,0,0
PMFB,0,0,0.00,0,0.00,0.00,0,0
PMJA,0,0,0.00,0,0.00,0.00,0,0
PMMR,0,0,0.00,0,0.00,0.00,0,0
PSCJ,0,0,0.00,0,0.00,0.00,0,0
PSCQ,0,0,0.00,0,0.00,0.00,0,0
PSCW,0,0,0.00,0,0.00,0.00,0,0
PSCX,0,0,0.00,0,0.00,0.00,0,0
PSFD,0,100,33.15,0,0.00,0.00,0,0
PSFM,0,0,0.00,0,0.00,0.00,0,0
PSFO,0,0,0.00,0,0.00,0.00,0,0
PSH,0,0,0.00,0,0.00,0.00,0,0
PSMD,0,0,0.00,0,0.00,0.00,0,0
PSMO,0,0,0.00,0,0.00,0.00,0,0
PSMR,0,0,0.00,0,0.00,0.00,0,0
PWS,0,0,0.00,4,28.81,0.00,0,0
QCAP,0,0,0.00,0,0.00,0.00,0,0
QMAG,0,0,0.00,0,0.00,0.00,0,0
QTAP,0,0,0.00,0,0.00,0.00,0,0
QTJA,0,0,0.00,0,0.00,0.00,0,0
RMIF,0,0,0.00,0,0.00,0.00,0,0
RODE,0,0,0.00,0,0.00,0.00,0,0
ROIS,0,0,0.00,0,0.00,0.00,0,0
RSBY,0,0,0.00,48,16.25,0.00,0,0
RTAI,0,0,0.00,0,0.00,0.00,0,0
RTRE,0,0,0.00,0,0.00,0.00,0,0
RVRB,0,0,0.00,0,0.00,0.00,0,0
SCEC,0,0,0.00,0,0.00,0.00,0,0
SCLZ,0,0,0.00,0,0.00,0.00,0,0
SEPP,0,0,0.00,0,0.00,0.00,0,0
SEPZ,0,0,0.00,0,0.00,0.00,0,0
SHAG,0,0,0.00,0,0.00,0.00,0,0
SNPV,0,0,0.00,0,0.00,0.00,0,0
SPCZ,0,0,0.00,0,0.00,0.00,0,0
SPMV,0,0,0.00,0,0.00,0.00,0,0
SQMX,0,0,0.00,0,0.00,0.00,0,0
TDEC,0,0,0.00,0,0.00,0.00,0,0
TEMX,0,0,0.00,0,0.00,0.00,0,0
TRIO,0,0,0.00,0,0.00,0.00,0,0
TRSY,0,0,0.00,210,27.10,0.00,0,0
TRTY,0,0,0.00,10,24.00,0.00,0,0
TSPX,0,0,0.00,0,0.00,0.00,0,0
TWOX,0,0,0.00,0,0.00,0.00,0,0
UMAY,0,0,0.00,0,0.00,0.00,0,0
UNOV,0,0,0.00,0,0.00,0.00,0,0
VMAX,0,0,0.00,0,0.00,0.00,0,0
WDNA,0,0,0.00,0,0.00,0.00,0,0
XBAP,0,0,0.00,0,0.00,0.00,0,0
XBJA,0,0,0.00,0,0.00,0.00,0,0
XDAT,0,0,0.00,0,0.00,0.00,0,0
XDOC,0,0,0.00,0,0.00,0.00,0,0
XJAN,0,0,0.00,0,0.00,0.00,0,0
XOCT,0,0,0.00,0,0.00,0.00,0,0
XTAP,0,0,0.00,0,0.00,0.00,0,0
XTJL,0,0,0.00,0,0.00,0.00,0,0
ZOCT,0,0,0.00,0,0.00,0.00,0,0
BRPR3.SA,0,0,0.00,0,0.00,0.00,0,0
BVMF3.SA,0,0,0.00,0,0.00,0.00,0,0
CTIP3.SA,0,0,0.00,0,0.00,0.00,0,0
FIBR3.SA,0,0,0.00,0,0.00,0.00,0,0
CSNA3.SA,0,0,0.00,0,0.00,0.00,0,0
CPFE3.SA,0,0,0.00,0,0.00,0.00,0,0
BBSE3.SA,0,0,0.00,0,0.00,0.00,0,0
ELET3.SA,0,0,0.00,0,0.00,0.00,0,0
BRAP4.SA,0,0,0.00,0,0.00,0.00,0,0
BBAS3.SA,0,0,0.00,0,0.00,0.00,0,0
ABEV3.SA,0,0,0.00,0,0.00,0.00,0,0
GGBR4.SA,0,0,0.00,0,0.00,0.00,0,0
CPLE6.SA,0,0,0.00,0,0.00,0.00,0,0
BBDC3.SA,0,0,0.00,0,0.00,0.00,0,0
CMIG4.SA,0,0,0.00,0,0.00,0.00,0,0
CSAN3.SA,0,0,0.00,0,0.00,0.00,0,0
CYRE3.SA,0,0,0.00,0,0.00,0.00,0,0
EQTL3.SA,0,0,0.00,0,0.00,0.00,0,0
EMBR3.SA,0,0,0.00,0,0.00,0.00,0,0
ECOR3.SA,0,0,0.00,0,0.00,0.00,0,0
LREN3.SA,0,0,0.00,0,0.00,0.00,0,0
AMER3.SA,0,0,0.00,0,0.00,0.00,0,0
VALE,0,0,0.00,0,0.00,0.00,0,0
BPAC11.SA,0,0,0.00,0,0.00,0.00,0,0
ITUB,0,0,0.00,0,0.00,0.00,0,0
